NO textures/20.xpm
SO textures/9.xpm
WE textures/21.xpm
EA textures/8.xpm
F 240 ,255 ,240
C 135, 206, 235



A111111111111A11111111111
11     111110001111111111
1111111111111D1111111100011
1010000000000000000001111
100000000000N000000001001111
10000000000000000000010001
1111111111111111D11111111
1000000000000000000000001
A000000000000000000000001
1000000000000000000000001
1000000000000000000000001
A11111111111111111111111A
