NO textures/20.xpm
SO textures/9.xpm
WE textures/21.xpm
EA textures/8.xpm
F 240 ,255 ,240
C 135, 206, 235

1111111111111111111111111111111111111111111111111111111111111111111111111111
10000000000000001
101000W0100000101
10000000000000001
10001000100010001
10000000000000001
10101010001010101
10000000000000001
10001000100100001
10000000000000001
10100000100001001
10000000000000001
11111111111111111